{
    "MapWidth": 10,
    "MapHeight": 6,
    "TileSize": 64,
    "TileData": [
    0, 0, 0, 0, 0, 0, 0, 0, 0, 0,
    0, 0, 0, 0, 0, 0, 0, 0, 0, 0,
    0, 0, 0, 0, 0, 0, 0, 0, 0, 0,
    0, 0, 2, 2, 2, 0, 0, 0, 0, 0,
    1, 1, 0, 0, 0, 0, 2, 2, 1, 1,
    1, 1, 1, 1, 1, 1, 1, 1, 1, 1
    ]
}